|--------------------------------------------------------------------------------------------------------------------------------------------------------------------------------------------------------------------------------|
|VVVVVVVVVVVVVVVVVVVVVVVVVVVVVVVVVVVVVVVVVVVVVVVVVV                                  VVVVVVVVVV\  \              /      /VVVVVVVVVVVVVVVVVVVVVVVVVV                                                                              |
|VVVVVVVVVVVVVVVVVVVVVVVVVVVVVVVVVVVVVVVV                                              VVVVVVVVV\  \            |      /VVVVVVVVVVVVVVVVVVV                                                                                      |
|VVVVVVVVVVVVVVVVVVVVVVVVVVVVVVVV                                                         VVVVVVV\  \           |     |VVVVVVVVVVVVV                                                                                             |
|VVVVVVVVVVVVVVVVVVVVVVVVVV                                                                  VVVVV|  \          |     |VVVVVVVVVV                                                                                                |
|VVVVVVVVVVVVVVVVVVVVVVV                                                                        VV|   \         |     |VVVVVVV                                                                                                   |
|VVVVVVVVVVVVVVVVVVVVV                                                                             \   \         \    |VVVVVV                                                                                                    |
|VVVVVVVVVVVVVVVVV                                                                                  |   \         \   \VVVVVVV                                                                                                   |
|VVVVVVVVVVVVV                                                                                       \   |         \   \VVVV                                                                                                     |
|VVVVVVVVVVV                                                                                          \   \         |   \VVVVV                                                                                                   |
|VVVVVVV                                                                                               |   |        |    \VVVVVV                                                                                                 |
|VVVVV                      T                                                                          |   |        |     |VVVVVV                                                                                                |
|VVVV                                                ~~~                                               |   |        |     |VVVVV                                                                                                 |
|VV                                             ~~~~~~~~~~~~~                                          |   |        |     |VVVVVV                                                                                                |
|V                                        ~~~~~~~~~~~~~~~~~~~~~~~~~                                    |   |        |    /VVVVVVV                                            ~~~~~~                                              |
|                                     ~~~~~~~~~~~~~~~~~~~~~~~~~~~~~~~~~~                               |   |     __/    /VVVVVV                                             ~~~~~~~~~~~~~                                        |
|                                   ~~~~~~~~~~~~~~~~~~~~~~~~~~~~~~~~~~~~~~~~~~~                        |    \  _/      /VVVVVV                                              ~~~~~~~~~~~~~~~~~~                                   |
|                                  ~~~~~~~~~~~~~~~~~~~~~~~~~~~~~~~~~~~~~~~~~~~~~~                       \    |/       |VVVVVVV                                               ~~~~~~~~~~~~~~~~~~~~~~~~~~                          |
+                                 ~~~~~~~~~~~~~~~~~~~~~~~~~~~~~~~~~~~~~~~~~~~~~~                         |           /VVV                                                     ~~~~~~~~~~~~~~~~~~~~~~~~~~~~~~                     +
+                              ~~~~~~~~~~~~~~~~~~~~~~~~~~~~~~~~~~~~~~~~~~~VVVVVV                         |          /VVVVVVV                                                    ~~~~~~~~~~~~~~~~~~~~~~~~~~~~~~~                  +
+                            ~~~~~~~~~~~~~~~~~~~~~~~~~~~~~~~~~~~~~~VVVVVVVVVV                           /          /VVVVVVVVV                                                    ~~~~~~~~~~~~~~~~~~~~~~~~~~~~                    +
|                          ~~~~~~~~~~~~~~~~~~~~~~~~~~~~~~VVVVVVVVVVVVVVVVV                             /          /VVVVVVVVVVVVV                                                ~~~~~~~~~~~~~~~~~~~~~~~                          |
|                        ~~~~~~~~~~~~~~~~~~~~VVVVVVVVVVVVVVVVVVVVVVVVVVV                              /          /VVVVVV                                                      ~~~~~~~~~~~~~~~~                                   |
|                       ~~~~~~~~~~~~~~~~~VVVVVVVVVVVVVVVVVVVVVVV                                     /          /VVVVV                                                       ~~~~~~~~~~~                                         |
|                      ~~~~~~~~~~~~~~~~VVVVVVVVVVVVVVVVVVVVV                                    ____/          /VVVVVVV                                                      ~~~~~~~~~~                                          | 
|                     ~~~~~~~~~~~~~~~~~~VVVVVVVVVVVVVVVVVVV                                    /            __/VVVVVVVVVV                                                   ~~~~~~~~~                                            |
|                     ~~~~~~~~~~~~~~~~~~~VVVVVVVVVVVVVVVVVVVV                         ________/            /VVVVVVVVVVVVVVVV                                                ~~~~~~~~~                                            |
|                    ~~~~~~~~~~~~~~~~~~~~~~VVVVVVVVVVVVVVVVVVVV                       \    _______        /VVVVVVVVVVVVVVV                                                  ~~~~~~~~~~~                                          |
|                   ~~~~~~~~~~~~~~~~~~~~~~~~~VVVVVVVVVVVVVVVVVV                        \   \      \      /VVVVVVVVVVVVVVV                                                  ~~~~~~~~~~~~~~                                        |
|                  ~~~~~~~~~~~~~~~~~~~~~~~~~~~~VVVVVVVVVVVVVVVVV                        \   \_____/     |VVVVVVVVVVVVV                                                     ~~~~~~~~~~~~~~~                                       |
|                 ~~~~~~~~~~~~~~~~~~~~~~~~~~~~~~~VVVVVVVVVVVVVV                          \_____        /VVVVVVVVVVV                                                       ~~~~~~~~~~~~~~~~~~                                     |
|                ~~~~~~~~~~~~~~~~~~~~~~~~~~~~~~~~~~~VVVVVVVVVV                                 \______/VVVVVVVVV                                                VVVVVVVVV~~~~~~~~~~~~~~~~~~~~~~                                  |
|               ~~~~~~~~~~~~~~~~~~~~~~~~~~~~~~~~~~~~~~~VVVVVV                                        VVVV                                                    VVVVVVVVVVV~~~~~~~~~~~~~~~~~~~~~~~~~                                |
|             ~~~~~~~~~~~~~~~~~~~~~~~~~~~~~~~~~~~~~~~~~~~~~V                                                                                           VVVVVVVVVVVVVVVV~~~~~~~~~~~~~~~~~~~~~~~~~~~~~                             |
|          ~~~~~~~~~~~~~~~~~~~~~~~~~~~~~~~~~~~~~~~~~~~~~~~~~~~~~                                                                                 VVVVVVVVVVVVVVVVVVV~~~~~~~~~~~~~~~~~~~~~~~~~~~~~~~~~~~~~                        |
|     ~~~~~~~~~~~~~~~~~~~~~~~~~~~~~~~~~~~~~~~~~~~~~~~~~~~~~~~~~~~~~~~~~~~~~                                                                VVVVVVVVVVVVVVVVVVVV~~~~~~~~~~~~~~~~~~~~~~~~~~~~~~~~~~~~~~~~~~~~~~~~~                 |
|~~~~~~~~~~~~~~~~~~~~~~~~~~~~~~~~~~~~~~~~~~~~~~~~~~~~~~~~~~~~~~~~~~~~~~~~~~~~~~~~~~~~~                                                VVVVVVVVVVVVVVVV~~~~~~~~~~~~~~~~~~~~~~~~~~~~~~~~~~~~~~~~~~~~~~~~~~~~~~~~~~~~~~~~~~~~~~~~~~~|
|~~~~~~~~~~~~~~~~~~~~~~~~~~~~~~~~~~~~~~~~~~~~~~~~~~~~~~~~~~~~~~~~~~~~~~~~~~~~~~~~~~~~~~~~~~~~~~~~~~~~~~~~~~~~~~~~~~~~~~~~~~~~~~~~~~~~~~~~~~~~~~~~~~~~~~~~~~~~~~~~~~~~~~~~~~~~~~~~~~~~~~~~~~~~~~~~~~~~~~~~~~~~~~~~~~~~~~~~~~~~~~~~|
|________________________________________________________________________________________________________________________________________________________________________________________________________________________________|